000111001110110
111111111111111
000000111100000
000000000000000
111111111100000
