333333333333333
333333333333333
333333333333333
333333333333333
111111111111111
000000111100000
0000000000000003453453455554345454
111111111100000
