000000000100122222222222000000
000000000100122222222222000000
000000000100122222222222000000
000000001100122222222222000000
000000001100122222222222000000
000000001100112222222333000000
000000000110111222223333000000
000000000110111122233333000000
000000001110111122333333000000
000000001110111122333333000003
000003001100011122333332033333
033333000100011122333322033333
033333001100011122222222033333
033333001100011222222222033333
033333000100011222222222031113
031113001111111122222222001110
001110001111111112222222001100
001100000111111111222222000000
000000000111111111122222000000
000000000111000222222222000000
000000001110000222222222000000
000000000000000222222222000000
000000000000000222222222000000
000000003300002222222222000000
